0 0 0 0 0 0 0 0 0 0 0 0 0 0 0 0 0 0 0 0 0 0 0 0 0 0 0 0 0 0
0 0 0 0 0 0 0 0 0 0 0 0 0 0 0 0 0 0 0 0 0 0 0 0 0 0 0 0 0 0
0 0 0 0 0 0 0 0 0 0 0 0 0 0 0 0 0 0 0 0 0 0 0 0 0 0 0 0 0 0
0 0 0 0 0 0 0 0 0 0 0 0 0 0 0 0 0 0 0 0 0 0 0 0 0 0 0 0 0 0
0 0 0 0 0 0 0 0 0 0 0 0 0 0 0 0 0 0 0 0 0 0 0 0 0 0 0 0 0 0
0 0 0 0 0 0 0 0 0 0 0 0 0 0 0 0 0 0 0 0 0 0 0 0 0 0 0 0 0 0
1 1 1 4 1 2 1 6 1 3 1 7 1 1 1 4 1 2 1 6 1 3 1 7 1 1 1 4 1 2
1 4 1 1 1 6 1 2 1 7 1 3 1 4 1 1 1 6 1 2 1 7 1 3 1 4 1 1 1 6
0 0 0 0 0 0 0 0 0 0 0 0 0 0 0 0 0 0 0 0 0 0 0 0 0 0 0 0 0 0
0 0 0 0 0 0 0 0 0 0 0 0 0 0 0 0 0 0 0 0 0 0 0 0 0 0 0 0 0 0
0 0 0 0 2 3 2 2 2 1 0 0 2 3 2 4 2 4 2 5 0 0 2 5 2 6 2 7 0 0
0 0 0 0 2 3 2 2 2 1 0 0 2 3 2 4 2 4 2 5 0 0 2 5 2 6 2 7 0 0
0 0 0 0 2 3 2 2 2 1 0 0 2 3 2 4 2 4 2 5 0 0 2 5 2 6 2 7 0 0
0 0 0 0 2 3 2 2 2 1 0 0 2 3 2 4 2 4 2 5 0 0 2 5 2 6 2 7 0 0
0 0 0 0 0 0 0 0 0 0 0 0 0 0 0 0 0 0 0 0 0 0 0 0 0 0 0 0 0 0
0 0 0 0 0 0 0 0 0 0 0 0 0 0 0 0 0 0 0 0 0 0 0 0 0 0 0 0 0 0
1 1 1 4 1 2 1 6 1 3 1 7 1 1 1 4 1 2 1 6 1 3 1 7 1 1 1 4 1 2
1 4 1 1 1 6 1 2 1 7 1 3 1 4 1 1 1 6 1 2 1 7 1 3 1 4 1 1 1 6