0 0 0 0 0 0 0 0 0 0 0 0 0 0 0 0 0 0 0 0 0 0 0 0 0 0 0 0 0 0
0 0 0 0 0 0 0 0 0 0 0 0 0 0 0 0 0 0 0 0 0 0 0 0 0 0 0 0 0 0
0 0 0 0 0 0 0 0 0 0 0 0 0 0 0 0 0 0 0 0 0 0 0 0 0 0 0 0 0 0
0 0 0 0 0 0 0 0 0 0 0 0 0 0 0 0 0 0 0 0 0 0 0 0 0 0 0 0 0 0
4 9 4 0 4 9 4 0 4 9 4 0 4 9 4 0 4 9 4 0 4 9 4 0 4 9 4 0 4 9
2 0 2 9 2 0 2 9 2 0 2 9 2 0 2 9 2 0 2 9 2 0 2 9 2 0 2 9 2 0
1 9 1 0 1 9 1 0 1 9 1 0 1 9 1 0 1 9 1 0 1 9 1 0 1 9 1 0 1 9
1 0 1 9 3 1 3 1 3 1 1 9 3 2 1 9 3 2 1 9 3 3 3 3 3 3 1 9 1 0
1 9 1 0 1 9 3 1 1 9 1 0 3 2 1 0 3 2 1 0 3 3 1 0 1 9 1 0 1 9
1 0 1 9 1 0 3 1 1 0 1 9 3 2 3 2 3 2 1 9 3 3 3 3 1 0 1 9 1 0
1 9 1 0 1 9 3 1 1 9 1 0 3 2 1 0 3 2 1 0 3 3 1 0 1 9 1 0 1 9
1 0 1 9 1 0 3 1 1 0 1 9 3 2 1 9 3 2 1 9 3 3 3 3 3 3 1 9 1 0
1 9 1 0 1 9 1 0 1 9 1 0 1 9 1 0 1 9 1 0 1 9 1 0 1 9 1 0 1 9
2 0 2 9 2 0 2 9 2 0 2 9 2 0 2 9 2 0 2 9 2 0 2 9 2 0 2 9 2 0
1 9 1 0 1 9 1 0 1 9 1 0 1 9 1 0 1 9 1 0 1 9 1 0 1 9 1 0 1 9
1 0 1 9 3 4 3 4 3 4 1 9 3 5 1 9 3 5 1 9 3 6 3 6 1 0 1 9 1 0
1 9 1 0 3 4 1 0 1 9 1 0 3 5 1 0 3 5 1 0 3 6 3 9 3 6 1 0 1 9
1 0 1 9 3 4 3 4 1 0 1 9 3 5 3 5 3 5 1 9 3 6 3 9 3 6 1 9 1 0
1 9 1 0 3 4 1 0 1 9 1 0 3 5 3 5 3 5 1 0 3 6 3 9 3 6 1 0 1 9
1 0 1 9 3 4 3 4 3 4 1 9 3 5 1 9 3 5 1 9 3 6 3 6 1 0 1 9 1 0
1 9 1 0 1 9 1 0 1 9 1 0 1 9 1 0 1 9 1 0 1 9 1 0 1 9 1 0 1 9
2 0 2 9 2 0 2 9 2 0 2 9 2 0 2 9 2 0 2 9 2 0 2 9 2 0 2 9 2 0
4 9 4 0 4 9 4 0 4 9 4 0 4 9 4 0 4 9 4 0 4 9 4 0 4 9 4 0 4 9