0 0 0 0 0 0 0 0 0 0 0 0 0 0 0 0 0 0 0 0 0 0 0 0 0 0 0 0 0 0
0 0 0 0 0 0 0 0 0 0 3 3 0 0 0 0 0 0 3 3 0 0 0 0 0 0 0 0 0 0
0 0 0 0 0 0 0 0 3 3 3 3 0 0 0 0 3 3 0 0 3 3 0 0 0 0 0 0 0 0
0 0 0 0 0 0 0 0 0 0 3 3 0 0 0 0 0 0 0 0 3 3 0 0 0 0 0 0 0 0
0 0 0 0 0 0 0 0 0 0 3 3 0 0 0 0 0 0 3 3 0 0 0 0 0 0 0 0 0 0
0 0 0 0 0 0 0 0 0 0 3 3 0 0 0 0 0 0 0 0 3 3 0 0 0 0 0 0 0 0
0 0 0 0 0 0 0 0 0 0 3 3 0 0 0 0 3 3 0 0 3 3 0 0 0 0 0 0 0 0
0 0 0 0 0 0 0 0 0 0 3 3 0 0 0 0 0 0 3 3 0 0 0 0 0 0 0 0 0 0
0 0 0 0 0 0 0 0 0 0 0 0 0 0 0 0 0 0 0 0 0 0 0 0 0 0 0 0 0 0
3 0 3 0 3 0 3 0 3 0 3 0 3 0 3 0 3 0 3 0 3 0 3 0 3 0 3 0 3 0
3 0 1 1 1 1 1 1 3 0 2 1 2 1 2 1 3 0 4 1 4 1 4 1 4 1 4 1 3 0
3 0 1 1 5 0 1 1 3 0 2 1 5 0 2 1 3 0 4 1 5 0 5 0 5 0 5 0 3 0
3 0 1 1 5 0 1 1 3 0 2 1 5 0 2 1 3 0 4 1 4 1 4 1 4 1 5 0 3 0
3 0 3 0 5 0 3 0 3 0 3 0 5 0 3 0 3 0 3 0 3 0 3 0 3 0 5 0 3 0
3 0 3 0 5 0 3 0 3 0 3 0 5 0 3 0 3 0 3 0 3 0 3 0 3 0 5 0 3 0
3 0 3 0 5 0 3 0 3 0 3 0 5 0 3 0 3 0 3 0 3 0 3 0 3 0 5 0 3 0
3 0 3 0 5 0 3 0 3 0 3 0 5 0 3 0 3 0 3 0 3 0 3 0 3 0 5 0 3 0