0 0 0 0 0 0 0 0 0 0 0 0 0 0 0 0 0 0 0 0 0 0 0 0 0 0 0 0 0 0
0 0 0 0 0 0 0 0 0 0 0 0 0 0 0 0 0 0 0 0 0 0 0 0 0 0 0 0 0 0
0 0 0 0 1 3 1 3 1 3 1 3 1 3 0 0 1 3 1 3 1 3 1 3 1 3 0 0 0 0
0 0 0 0 1 3 1 3 1 3 1 3 1 3 0 0 1 3 1 3 1 3 1 3 1 3 0 0 0 0
0 0 0 0 1 3 1 3 1 3 1 3 1 3 0 0 1 3 1 3 1 3 1 3 1 3 0 0 0 0
0 0 0 0 1 3 1 3 1 3 1 3 1 3 0 0 1 3 1 3 1 3 1 3 1 3 0 0 0 0
0 0 0 0 1 3 1 3 1 3 1 3 1 3 0 0 1 3 1 3 1 3 1 3 1 3 0 0 0 0
0 0 0 0 1 3 1 3 1 3 1 3 0 0 0 0 0 0 1 3 1 3 1 3 1 3 0 0 0 0
0 0 0 0 1 3 1 3 1 3 0 0 1 9 1 2 1 5 0 0 1 3 1 3 1 3 0 0 0 0
0 0 0 0 1 3 1 3 0 0 1 8 1 3 1 9 1 2 1 5 0 0 1 3 1 3 0 0 0 0
0 0 0 0 1 3 0 0 1 1 1 6 1 8 1 3 1 9 1 2 1 5 0 0 1 3 0 0 0 0
0 0 0 0 1 3 0 0 1 4 1 1 1 6 1 8 1 3 1 9 1 2 0 0 1 3 0 0 0 0
0 0 0 0 1 3 0 0 1 5 1 4 1 1 1 6 1 8 1 3 1 9 0 0 1 3 0 0 0 0
0 0 0 0 1 3 1 3 0 0 1 5 1 4 1 1 1 6 1 8 0 0 1 3 1 3 0 0 0 0
0 0 0 0 1 3 1 3 1 3 0 0 1 5 1 4 1 1 0 0 1 3 1 3 1 3 0 0 0 0
0 0 0 0 1 3 1 3 1 3 1 3 0 0 0 0 0 0 1 3 1 3 1 3 1 3 0 0 0 0
0 0 0 0 1 3 1 3 1 3 1 3 1 3 1 3 1 3 1 3 1 3 1 3 1 3 0 0 0 0
0 0 0 0 1 3 1 3 1 3 1 3 1 3 1 3 1 3 1 3 1 3 1 3 1 3 0 0 0 0