0 0 0 0 0 0 0 0 0 0 0 0 0 0 0 0 0 0 0 0 0 0 0 0 0 0 0 0 0 0
0 0 0 0 0 0 0 0 0 0 0 0 0 0 0 0 0 0 0 0 0 0 0 0 0 0 0 0 0 0
3 1 3 1 3 1 3 1 3 1 3 1 3 1 1 0 3 1 3 1 3 1 3 1 3 1 3 1 3 1
0 0 0 0 0 0 0 0 0 0 0 0 0 0 0 0 0 0 0 0 0 0 0 0 0 0 0 0 0 0
3 2 3 2 3 2 3 2 3 2 3 2 3 2 4 0 3 2 3 2 3 2 3 2 3 2 3 2 3 2
0 0 0 0 0 0 0 0 0 0 0 0 0 0 0 0 0 0 0 0 0 0 0 0 0 0 0 0 0 0
3 3 3 3 3 3 3 3 3 3 3 3 3 3 4 0 3 3 3 3 3 3 3 3 3 3 3 3 3 3
0 0 0 0 0 0 0 0 0 0 0 0 0 0 0 0 0 0 0 0 0 0 0 0 0 0 0 0 0 0
3 4 3 4 3 4 3 4 3 4 3 4 3 4 4 0 3 4 3 4 3 4 3 4 3 4 3 4 3 4
0 0 0 0 0 0 0 0 0 0 0 0 0 0 0 0 0 0 0 0 0 0 0 0 0 0 0 0 0 0
3 5 3 5 3 5 3 5 3 5 3 5 3 5 4 0 3 5 3 5 3 5 3 5 3 5 3 5 3 5
0 0 0 0 0 0 0 0 0 0 0 0 0 0 0 0 0 0 0 0 0 0 0 0 0 0 0 0 0 0
3 6 3 6 3 6 3 6 3 6 3 6 3 6 4 0 3 6 3 6 3 6 3 6 3 6 3 6 3 6
0 0 0 0 0 0 0 0 0 0 0 0 0 0 0 0 0 0 0 0 0 0 0 0 0 0 0 0 0 0
3 7 3 7 3 7 3 7 3 7 3 7 3 7 4 0 3 7 3 7 3 7 3 7 3 7 3 7 3 7
0 0 0 0 0 0 0 0 0 0 0 0 0 0 0 0 0 0 0 0 0 0 0 0 0 0 0 0 0 0
3 8 3 8 3 8 3 8 3 8 3 8 3 8 4 0 3 8 3 8 3 8 3 8 3 8 3 8 3 8
