0 0 0 0 0 0 0 0 0 0 0 0 0 0 0 0 0 0 0 0 0 0 0 0 0 0 0 0 0 0
0 0 0 0 0 0 0 0 0 0 0 0 0 0 0 0 0 0 0 0 0 0 0 0 0 0 0 0 0 0
0 0 0 0 0 0 0 0 0 0 0 0 0 0 0 0 0 0 0 0 0 0 0 0 0 0 0 0 0 0
0 0 0 0 0 0 0 0 0 0 0 0 0 0 0 0 0 0 0 0 0 0 0 0 0 0 0 0 0 0
0 0 0 0 2 3 1 9 2 3 1 9 2 3 1 9 2 3 1 9 2 3 1 9 2 3 0 0 0 0
0 0 0 0 1 9 1 1 1 9 1 1 1 9 1 1 1 9 1 1 1 9 1 1 1 9 0 0 0 0
0 0 0 0 2 3 1 9 2 3 1 9 2 3 1 9 2 3 1 9 2 3 1 9 2 3 0 0 0 0
0 0 0 0 1 9 1 1 1 9 1 1 1 9 1 1 1 9 1 1 1 9 1 1 1 9 0 0 0 0
0 0 0 0 2 3 1 9 2 3 1 9 2 3 1 9 2 3 1 9 2 3 1 9 2 3 0 0 0 0
0 0 0 0 1 9 1 1 1 9 1 1 1 9 1 1 1 9 1 1 1 9 1 1 1 9 0 0 0 0
0 0 0 0 2 3 1 9 2 3 1 9 2 3 1 9 2 3 1 9 2 3 1 9 2 3 0 0 0 0
0 0 0 0 1 9 1 1 1 9 1 1 1 9 1 1 1 9 1 1 1 9 1 1 1 9 0 0 0 0
0 0 0 0 2 3 1 9 2 3 1 9 2 3 1 9 2 3 1 9 2 3 1 9 2 3 0 0 0 0
0 0 0 0 1 9 1 1 1 9 1 1 1 9 1 1 1 9 1 1 1 9 1 1 1 9 0 0 0 0
0 0 0 0 2 3 1 9 2 3 1 9 2 3 1 9 2 3 1 9 2 3 1 9 2 3 0 0 0 0