3 2 3 2 3 2 3 2 3 2 3 2 3 2 3 2 3 2 3 2 3 2 3 2 3 2 3 2 3 2
3 2 3 2 3 2 1 0 3 2 3 2 5 0 5 0 3 2 3 2 3 2 3 2 1 0 1 0 3 2
3 2 3 2 1 0 1 0 3 2 1 0 1 0 1 0 1 0 3 2 3 2 1 0 1 0 1 0 3 2
3 2 3 2 1 0 1 0 3 2 1 0 1 0 1 0 1 0 3 2 3 2 1 0 1 0 1 0 3 2
3 2 1 0 1 0 1 0 1 0 1 0 1 0 1 0 1 0 3 2 3 2 1 0 1 0 1 0 3 2
3 2 1 0 1 0 1 0 1 0 1 0 1 0 1 0 1 0 3 2 5 0 1 0 1 0 1 0 3 2
3 2 1 0 1 0 1 0 1 0 1 0 1 0 1 0 1 0 3 2 1 0 1 0 1 0 1 0 3 2
3 2 1 0 1 0 1 0 5 0 4 9 5 0 1 0 1 0 1 0 1 0 1 0 1 0 1 0 3 2
3 2 1 0 1 0 1 0 3 2 3 2 3 2 1 0 1 0 1 0 1 0 1 0 1 0 4 9 3 2
3 2 4 9 1 0 1 0 1 0 1 0 1 0 1 0 1 0 1 0 1 0 1 0 1 0 3 2 3 2
3 2 3 2 1 0 1 0 1 0 1 0 1 0 1 0 1 0 1 0 1 0 1 0 1 0 3 2 3 2
3 2 3 2 1 0 1 0 1 0 1 0 1 0 1 0 1 0 1 0 1 0 1 0 5 0 3 2 3 2
3 2 3 2 1 0 1 0 1 0 1 0 1 0 1 0 1 0 1 0 1 0 1 0 3 2 3 2 3 2
3 2 1 0 1 0 1 0 1 0 1 0 1 0 1 0 1 0 1 0 1 0 1 0 3 2 3 2 3 2
3 2 1 0 1 0 1 0 1 0 1 0 1 0 1 0 5 0 1 0 1 0 1 0 3 2 3 2 3 2
3 2 1 0 1 0 1 0 1 0 1 0 1 0 1 0 3 2 1 0 1 0 1 0 3 2 4 9 3 2
3 2 1 0 1 0 1 0 1 0 1 0 1 0 3 2 3 2 1 0 1 0 1 0 1 0 1 0 3 2
3 2 1 0 1 0 1 0 1 0 1 0 1 0 1 0 3 2 1 0 1 0 1 0 1 0 1 0 3 2
1 0 1 0 1 0 1 0 1 0 1 0 1 0 1 0 3 2 3 2 1 0 1 0 1 0 1 0 1 0
1 0 1 0 1 0 5 0 1 0 1 0 1 0 3 2 3 2 3 2 1 0 1 0 1 0 1 0 1 0
1 0 3 2 3 2 3 2 3 2 3 2 3 2 3 2 3 2 3 2 3 2 3 2 3 2 3 2 1 0