1 5 1 5 1 5 1 5 1 5 1 5 1 5 1 5 3 9 3 9 3 9 3 9 3 9 3 3 3 3
1 5 1 5 1 5 1 5 1 5 1 5 1 5 1 5 1 5 3 9 3 9 3 9 3 3 3 3 3 3
1 5 1 5 3 9 3 9 1 5 1 5 1 5 1 5 1 5 1 5 1 5 1 5 3 3 3 3 3 3
1 5 3 9 3 9 3 9 3 9 1 5 1 5 1 5 1 5 1 5 1 5 1 5 1 5 3 3 3 3
3 9 3 9 3 9 3 9 3 9 3 9 1 5 1 5 1 5 1 5 1 5 1 5 1 5 1 5 3 3
1 5 1 5 1 5 1 5 1 5 1 5 1 5 1 5 1 5 1 5 1 5 1 5 1 5 1 5 1 5
1 5 1 5 1 5 1 5 1 5 1 5 1 5 1 5 1 5 1 5 1 5 1 5 1 5 1 5 1 5
1 5 1 5 1 5 1 5 1 5 1 5 1 5 1 5 1 5 1 5 1 5 1 4 1 5 1 5 1 5
1 5 1 5 1 5 1 5 1 5 1 0 1 5 1 5 1 5 1 5 1 4 1 4 1 4 1 5 1 5
1 5 1 5 1 5 1 5 1 5 1 0 1 5 1 5 1 5 1 5 1 4 1 4 1 4 1 5 1 5
1 5 1 5 4 1 4 1 4 1 4 1 4 1 1 5 1 5 1 5 1 4 1 4 1 4 1 5 1 5
1 5 4 1 2 2 2 2 2 2 2 2 2 2 4 1 1 5 1 5 1 5 1 4 1 5 1 5 1 5
1 5 1 5 2 2 1 9 2 2 1 9 2 2 1 5 1 5 1 5 1 5 1 2 1 5 1 5 1 5
1 5 1 5 2 2 1 9 2 2 1 9 2 2 1 5 1 5 1 5 1 5 1 2 1 5 1 5 1 5
1 5 1 5 2 2 2 2 2 2 2 2 2 2 1 5 1 5 1 5 1 5 1 2 1 5 1 5 1 5
1 5 1 5 2 2 2 2 2 1 2 2 2 2 1 5 1 5 1 5 1 5 1 2 1 5 1 5 1 5
1 5 1 5 2 2 2 2 2 1 2 2 2 2 1 5 1 5 1 5 1 5 1 2 1 5 1 5 1 5
1 5 1 5 2 2 2 2 2 1 2 2 2 2 1 5 1 5 1 5 1 5 1 2 1 5 1 5 1 5
2 4 2 4 2 4 2 4 2 4 2 4 2 4 2 4 2 4 2 4 2 4 2 4 2 4 2 4 2 4
2 4 4 3 2 4 2 4 2 4 4 3 2 4 2 4 2 4 4 8 2 4 2 4 2 4 4 3 2 4
4 8 2 4 2 4 2 4 2 4 2 4 2 4 4 8 2 4 2 4 2 4 2 4 2 4 2 4 2 4