0 0 0 0 0 0 0 0 0 0 0 0 0 0 0 0 0 0 0 0 0 0 0 0 0 0 0 0 0 0
0 0 3 6 0 0 0 0 3 6 0 0 3 6 0 0 3 6 0 0 0 0 3 6 3 6 3 6 0 0
0 0 3 6 0 0 0 0 3 6 0 0 3 6 0 0 3 6 0 0 0 0 0 0 0 0 3 6 0 0
0 0 3 6 0 0 0 0 3 6 0 0 3 6 0 0 3 6 0 0 0 0 0 0 0 0 3 6 0 0
0 0 3 6 0 0 0 0 3 6 0 0 3 6 0 0 3 6 0 0 0 0 0 0 0 0 3 6 0 0
0 0 3 6 3 6 0 0 0 0 3 6 0 0 0 0 3 6 3 6 0 0 0 0 0 0 3 6 0 0
0 0 0 0 0 0 0 0 0 0 0 0 0 0 0 0 0 0 0 0 0 0 0 0 0 0 0 0 0 0
3 9 3 9 3 9 3 9 3 9 3 9 3 9 3 9 3 9 3 9 3 9 3 9 3 9 3 9 3 9
0 0 0 0 0 0 0 0 0 0 0 0 0 0 0 0 0 0 0 0 0 0 0 0 0 0 0 0 0 0
0 0 0 0 0 0 0 0 0 0 0 0 0 0 0 0 0 0 0 0 0 0 0 0 0 0 0 0 0 0
0 0 0 0 0 0 0 0 0 0 0 0 0 0 0 0 0 0 0 0 0 0 0 0 0 0 0 0 0 0
0 0 0 0 0 0 0 0 0 0 0 0 0 0 0 0 0 0 0 0 0 0 0 0 0 0 0 0 0 0
0 0 3 0 1 4 1 1 1 4 1 1 1 4 1 1 1 4 1 1 1 4 1 1 1 4 3 0 0 0
0 0 3 0 1 4 1 1 1 4 1 1 1 4 1 1 1 4 1 1 1 4 1 1 1 4 3 0 0 0
0 0 3 0 1 4 1 1 1 4 1 1 1 4 1 1 1 4 1 1 1 4 1 1 1 4 3 0 0 0
0 0 3 0 1 4 1 1 1 4 1 1 1 4 1 1 1 4 1 1 1 4 1 1 1 4 3 0 0 0
0 0 3 0 3 0 3 0 3 0 3 0 3 0 3 0 3 0 3 0 3 0 3 0 3 0 3 0 0 0