0 0 0 0 0 0 0 0 0 0 0 0 0 0 0 0 0 0 0 0 0 0 0 0 0 0 0 0 0 0
0 0 0 0 0 0 0 0 0 0 0 0 0 0 0 0 0 0 0 0 0 0 0 0 0 0 0 0 0 0
0 0 0 0 0 0 0 0 0 0 0 0 0 0 0 0 0 0 0 0 0 0 0 0 0 0 0 0 0 0
0 0 0 0 0 0 0 0 0 0 0 0 0 0 0 0 0 0 0 0 0 0 0 0 0 0 0 0 0 0
0 0 0 0 0 0 0 0 0 0 0 0 0 0 0 0 0 0 0 0 0 0 0 0 0 0 0 0 0 0
0 0 0 0 2 1 2 1 2 1 0 0 2 4 2 4 2 4 0 0 2 1 2 1 2 1 0 0 0 0
0 0 0 0 2 1 4 0 2 1 0 0 2 4 4 0 2 4 0 0 2 1 4 0 2 1 0 0 0 0
0 0 0 0 2 1 2 1 2 1 0 0 2 4 2 4 2 4 0 0 2 1 2 1 2 1 0 0 0 0
0 0 0 0 0 0 0 0 0 0 0 0 0 0 0 0 0 0 0 0 0 0 0 0 0 0 0 0 0 0
0 0 0 0 0 0 0 0 0 0 0 0 0 0 0 0 0 0 0 0 0 0 0 0 0 0 0 0 0 0
0 0 0 0 0 0 0 0 0 0 0 0 0 0 0 0 0 0 0 0 0 0 0 0 0 0 0 0 0 0
2 3 2 3 2 3 0 0 2 7 2 7 2 7 0 0 2 3 2 3 2 3 0 0 2 7 2 7 2 7
2 3 4 0 2 3 0 0 2 7 4 0 2 7 0 0 2 3 4 0 2 3 0 0 2 7 4 0 2 7
2 3 2 3 2 3 0 0 2 7 2 7 2 7 0 0 2 3 2 3 2 3 0 0 2 7 2 7 2 7
0 0 0 0 0 0 0 0 0 0 0 0 0 0 0 0 0 0 0 0 0 0 0 0 0 0 0 0 0 0
0 0 0 0 0 0 0 0 0 0 0 0 0 0 0 0 0 0 0 0 0 0 0 0 0 0 0 0 0 0
0 0 0 0 0 0 0 0 0 0 0 0 0 0 0 0 0 0 0 0 0 0 0 0 0 0 0 0 0 0
0 0 0 0 2 0 2 0 2 0 0 0 2 9 2 9 2 9 0 0 2 0 2 0 2 0 0 0 0 0
0 0 0 0 2 0 4 0 2 0 0 0 2 9 4 0 2 9 0 0 2 0 4 0 2 0 0 0 0 0
0 0 0 0 2 0 2 0 2 0 0 0 2 9 2 9 2 9 0 0 2 0 2 0 2 0 0 0 0 0